................................................................................
.        .                                                            .        .
..........                                                            ..........
.        .                                                            .        .
.        .                                                            .        .
.        .                                                            .        .
.        .                                                            .        .
.        .                                                            .        .
.        .                                                            .        .
.        .                                                            .        .
.        .                                                            .        .
.        .                                                            .        .
.        .                                                            .        .
.        .                                                            .        .
.        .                                                            .        .
.        .                                                            .        .
.        .                                                            .        .
.        .                                                            .        .
.        .                                                            .        .
.        .                                                            .        .
.        .                                                            .        .
.        .                                                            .        .
.        .                                                            .        .
.        .                                                            .        .
................................................................................